x0x0x0x0x0x0x0x0x0x0x0x0x0x0x0x0x0x0x0x0x0x
0x1x1x0x1x1x0x1x1x1x1x1x1x1x1x1x1x1x1x1x1x0
x1x0x1x1x0x0x1x0x0x0x0x0x0x0x0x0x1x0x0x0x1x
0x1x0x1x0x1x1x0x1x0x1x0x1x1x1x1x0x1x0x1x1x0
x0x1x1x0x1x0x0x1x1x1x1x1x0x0x0x1x0x1x1x0x0x
0x1x0x0x1x0x1x1x0x1x0x0x1x1x0x0x0x1x0x1x0x0
x1x0x1x1x0x1x0x0x0x0x0x0x1x0x0x1x0x0x0x1x0x
0x0x1x0x0x0x0x1x1x1x1x0x0x0x1x0x1x1x0x0x1x0
x1x0x0x1x0x1x1x0x0x0x1x1x1x1x1x0x1x1x0x0x1x
0x1x1x0x0x1x0x1x0x1x0x0x0x1x0x1x0x0x1x1x1x0
x1x0x1x1x1x0x0x1x0x1x1x0x0x0x0x1x1x0x0x0x0x
0x0x1x0x0x1x1x0x1x0x0x1x1x1x1x0x0x1x1x1x0x0
x1x1x0x1x0x0x0x0x1x1x0x0x0x0x1x1x0x1x0x1x0x
0x0x0x1x1x1x1x1x1x0x1x1x1x1x0x0x1x0x0x0x1x0
x1x1x1x0x0x0x0x0x0x0x1x0x0x1x1x0x1x1x1x0x1x
0x0x1x1x0x1x0x1x1x1x1x1x1x0x0x1x0x0x1x0x1x0
x1x0x0x1x1x1x1x0x1x0x0x1x0x0x1x1x1x0x1x1x0x
0x0x1x1x0x0x0x1x0x1x1x0x0x1x1x0x0x0x0x0x1x0
x1x1x0x0x1x1x0x1x1x0x0x0x1x0x0x0x1x1x1x0x1x
0x0x0x1x1x0x1x0x0x1x0x1x0x1x1x1x0x0x1x0x0x0
x1x1x1x0x0x0x0x1x0x1x1x0x0x0x0x1x1x0x0x0x1x
0x0x1x1x1x1x1x1x1x0x0x1x0x0x0x1x0x1x1x0x0x0
x1x1x0x0x0x0x0x0x0x0x0x1x0x0x1x0x0x0x1x0x1x
0x0x1x1x0x1x0x0x1x1x0x0x0x0x1x1x1x1x0x0x1x0
x0x0x0x1x1x1x1x1x0x1x0x1x0x1x0x1x0x0x1x1x0x
0x1x0x1x0x0x0x0x0x0x1x1x0x0x0x1x0x1x0x0x1x0
x1x0x1x0x1x1x1x1x0x0x0x0x0x1x1x0x1x1x1x0x0x
0x1x1x1x0x0x0x0x1x1x1x1x1x0x0x0x1x0x0x1x1x0
x0x0x0x1x0x1x1x0x0x0x0x0x1x1x1x0x0x0x0x0x1x
0b1x1x1x1x1x0x1x1x1x1x1x0x1x0x1x1x1x1x0x1c0
x0x0x0x0x0x0x0x0x0x0x0x0x0x0x0x0x0x0x0x0x0x